ctrai	con trai
khôg	không
bme	bố mẹ
cta	chúng ta
mih	mình
cmnl	con mẹ nó luôn
mqh	mối quan hệ
ùi	rồi
sem	xem
pải	phải
đel	đéo
cgai	con gái
nhữg	những
mng	mọi người
r	rồi
qtam	quan tâm
thươg	thương
lun	luôn
cute	dễ thương
kute	dễ thương
ưi	ơi
kao	tao
tau	tao
gê	ghê
ge	ghê
kau	tao
rùi	rồi
qtâm	quan tâm
share	chia sẻ
chug	chung
vại	vậy
trườg	trường
hjx	hic
hix	hic
thoy	thôi
oy	rồi
đki	đăng ký
àk	à
qcao	quảng cáo
pr	quảng cáo
cv	công việc
tr	trời
vch	vãi chưởng
cùg	cùng
thjck	thích
thjk	thích
ktra	kiểm tra
cgái	con gái
nthe	như thế
chúg	chúng
tìh	tình
phòg	phòng
lòg	lòng
từg	từng
rằg	rằng
sốg	sống
thuj	thôi
càg	càng
đky	đăng ký
dể	dễ
ukm	ừ
bằg	bằng
sviên	sinh viên
đág	đáng
nvay	như vậy
vv	vui vẻ
v	vậy
xg	xong
zồi	rồi
trag	trang
zữ	dữ
atrai	anh trai
kte	kinh tế
độg	động
gắg	gắng
đzai	đẹp trai
thgian	thời gian
đồg	đồng
btrai	bạn trai
vler	vãi lồn
pccc	phòng cháy chữa cháy
nthê	như thế
vọg	vọng
đôg	đông
răg	răng
thườg	thường
tcảm	tình cảm
đứg	đứng
ksao	không sao
đĩ	đỉ
đũy	đỉ
s	sao
dz	đẹp trai
cmày	chúng mày
xuốg	xuống
nkư	như
lquan	liên quan
tiếg	tiếng
xih	xinh
lày	này
dug	đúng
đug	đúng
hìh	hình
hắt	hất
thàh	thành
ngke	nghe
dzậy	dậy
nghen	nha
ngheng	nha
tnào	thế nào
bede	bê đê
buê đuê	bê đê
tưởg	tưởng
đx	được
ctrinh	chương trình
phog	phong
hog	không
hôg	không
zìa	về
kũg	cũng
ntnao	như thế nào
tnao	thế nào
trọg	trọng
nthế	như thế
dzớ dzẩn	vớ vẩn
năg	năng
éo	đéo
ngđó	người đó
lquen	làm quen
dell	đéo
del	đéo
riêg	riêng
ngag	ngang
chộm	trộm
bnhiu	bao nhiêu
ngốk	ngốc
kậu	cậu
kqua	kết quả
kq	kết quả
htrc	hôm trước
địh	định
gđình	gia đinh
giốg	giống
csống	cuộc sống
zùi	rồi
bnhiêu	bao nhiêu
cbị	chuẩn bị
kòn	còn
buôg	buông
csong	cuộc sống
chàg	chàng
sad	buồn
đma	đụ má
nà	là
chăg	chăng
ngàh	ngành
llac	liên lạc
nkưng	nhưng
xink	xinh
nắg	nắng
tíh	tính
khoảg	khoảng
thík	thích
ngđo	người đó
ngkhác	người khác
thẳg	thẳng
kảm	cảm
dàh	dành
júp	giúp
lặg	lặng
vđê	vấn đề
bbè	bạn bè
bóg	bóng
dky	đăng ký
dòg	dòng
uốg	uống
nvien	nhân viên
tyêu	tình yêu
snvv	sinh nhật vui vẻ
đthoại	điện thoại
qhe	quan hệ
cviec	công việc
tượg	tượng
qà	quà
thjc	thích
nhưq	nhưng
cđời	cuộc đời
bthường	bình thường
zà	già
đáh	đánh
xloi	xin lỗi
xlũi	xin lỗi
lũi	lỗi
zám	dám
qtrọng	quan trọng
bìh	bình
lzi	làm gì
qhệ	quan hệ
kủa	của
đóg	đóng
ngulon	ngu lồn
cka	cha
lgi	làm gì
nvậy	như vậy
qả	quả
đkiện	điều kiện
mi	mày
dụg	dụng
mj	mày
nèk	nè
tlai	tương lai
bsĩ	bác sĩ
vde	vấn đề
chta	chúng ta
òy	rồi
ltinh	linh tinh
bome	bỏ mẹ
ngyeu	người yêu
thank	cảm ơn
tks	cảm ơn
thanks	cảm ơn
đthoai	điện thoại
snghĩ	suy nghĩ
nặg	nặng
họk	học
móa	má
zl	vãi lồn
dừg	dừng
hphúc	hạnh phúc
nge	nghe
wtâm	quan tâm
fa	cô đơn
thíck	thích
chuện	chuyện
lạh	lạnh
ntnày	như thế này
dek	đéo
thèn	thằng
cức	cứt
mé	má
ẻm	em
lúk	lúc
haj	hai
kím	kiếm
ngía	nghía
mớj	mới
hsơ	hồ sơ
ctraj	con trai
nyêu	người yêu
dma	đụ má
c	chị
kih	kinh
kb	kết bạn
dthương	dễ thương
dth	dễ thương
thíck	thích
nhìu	nhiều
ctrình	chương trình
mìnk	mình
mjh	mình
ng	người
vc	vãi cặc
ck	chồng
thỳ	thì
nyc	người yêu cũ
ex	người yêu cũ
nàg	nàng
thui	thôi
đjên	điên
bgái	bạn gái
zới	với
xink	xinh
hđộng	hành động
đhọc	đại học
yêuc	yêu
đóa	đó
đ	đéo
đuỵt	địt
mk	mình
thik	thích
ci	chị
sx	sản xuất
vailon	vãi lồn
sxuat	sản xuất
mn	mọi người
nógn	nóng
free	miễn phí
hok	không
vlon	vãi lồn
vlol	vãi lồn
ditme	địt mẹ
list	danh sách
mm	mẹ mày
m	mày
ko	không
bik	biết
dume	đụ mẹ
t	tao
đume	đụ mẹ
vs	với
cx	cũng
mik	mình
đc	được
hag	hàng
hk	không
n	nó
hàg	hàng
ngta	người ta
gđ	gia đình
ah	à
vlone	vãi lồn
đcđ	đéo chịu được
dcd	đéo chịu được
vk	vợ
cc	 con cặc
ctác	công tác
sg	sài gòn
dmm	địt mẹ mày
dm	đụ mẹ
đm	đụ mẹ
dcm	địt con mẹ
đcm	địt con mẹ
đmm	địt mẹ mày
dkm	địt con mẹ
ae	anh em
rì	gì
vl	vãi lồn
ms	mới
vn	việt nam
cũg	cũng
bit	biết
đag	đang
cmm	con mẹ mày
cmnr	con mẹ nó rồi
hnay	hôm nay
tq	trung quốc
ctr	chương trình
nch	nói chuyện
block	chặn
nta	người ta
ngèo	nghèo
kêh	kênh
ak	à
j	gì
ny	người yêu
qc	quảng cáo
baoh	bao giờ
zui	vui
zẻ	vẻ
tym	tim
aye	anh yêu em
eya	em yêu anh
z	vậy
zậy	vậy
thich	thích
vcl	vãi cả lồn
đt	điện thoại
cl	cái lồn
lol	lồn
loz	lồn
đuma	đụ má
lz	lồn
trc	trước
chs	chẳng hiểu sao
đhs	đéo hiểu sao
dhs	đéo hiểu sao
qá	quá
ntn	như thế nào
wá	quá
duma	đụ má
zậy	vậy
zô	vô
vđ	vãi đái
vchg	vãi chưởng
ml	mặt lồn
sml	sấp mặt lồn
xl	xin lỗi
cmn	con mẹ nó
cute	dễ thương
cmt	bình luận
ns	nói
iu	yêu
ctay	chia tay
ju	yêu
vcđ	vãi cả đái
qq	quằn què
kh	không
zạ	dạ
mis	nhớ
oy	rồi
h	giờ
jo	giờ
clmm	cái lồn mẹ mày
troai	trai
wa	quá
e	em
ji	gì
ce	chị em
lm	làm
đz	đẹp giai
hỏg	hỏng
hoy	thôi
đbh	đéo bao giờ
dbh	đéo bao giờ
k	không
vd	ví dụ
a	anh
cty	công ty
lở	lỡ
kô	không
hqua	hôm qua
xog	xong
nhoé	nhé
biet	biết
bjk	biết
bjt	biết
quí	quý
kbh	không bao giờ
stk	số tài khoản
nghành	ngành
trog	trong
tgian	thời gian
cf	cà phê
cafe	cà phê
biêt	biết
tđn	thế đéo nào
bth	bình thường
vcđ	vãi cả đái
tgd	thế giới di động
khg	không
nhưg	nhưng
thằg	thằng
đuợc	được
hj	hi
dc	được
đc	được
ku	cu
thým	thím
zô	dô
zú	vú
sđt	số điện thoại
klq	không liên quan
vkl	vãi cả lồn